14 14 14 14 14 14 14 14 14 14 14 14 14 14 14 14 14 14 14 14 14 14 14 14 14 14 14 14 14 14 14 14 14 14 14 14 14 14 14 14 14 14 14 14 14 14 14 14 14 14
14 14 14 14 14 14 14 14 14 14 14 14 14 14 14 14 14 14 14 14 14 14 14 14 14 14 14 14 14 14 14 14 14 14 14 14 14 14 14 14 14 14 14 14 14 14 14 14 14 14
14 14 14 14 14 14 14 14 14 14 14 14 14 14 14 14 14 14 14 14 14 14 14 14 14 14 14 14 14 14 14 14 14 14 14 14 14 14 14 14 14 14 14 14 14 14 14 14 14 14
14 14 14 14 14 14 14 14 14 14 14 14 14 14 14 14 14 14 14 14 14 14 14 14 14 14 14 14 14 14 14 14 14 14 14 14 14 14 14 14 14 14 14 14 14 14 14 14 14 14
14 14 14 14 14 14 14 14 14 14 14 14 14 14 14 14 14 14 14 14 14 14 14 14 14 14 14 14 14 14 14 14 14 14 14 14 14 14 14 14 14 14 14 14 14 14 14 14 14 14
14 14 14 14 14 14 14 14 14 14 14 14 14 14 14 14 14 14 14 14 14 14 14 14 14 14 14 14 14 14 14 14 14 14 14 14 14 14 14 14 14 14 14 14 14 14 14 14 14 14
14 14 14 14 14 14 14 14 14 14 14 14 14 14 14 14 14 14 14 14 14 14 14 14 14 14 14 14 14 14 14 14 14 14 14 14 14 14 14 14 14 14 14 14 14 14 14 14 14 14
14 14 14 14 14 14 14 14 14 14 14 14 14 14 14 14 14 14 14 14 14 14 14 14 14 14 14 14 14 14 14 14 14 14 14 14 14 14 14 14 14 14 14 14 14 14 14 14 14 14
14 14 14 14 14 14 14 14 14 14 14 14 14 14 14 14 14 14 14 14 14 14 14 14 14 14 14 14 14 14 14 14 14 14 14 14 14 14 14 14 14 14 14 14 14 14 14 14 14 14
14 14 14 14 14 14 14 14 14 14 14 14 14 14 14 14 14 14 14 14 14 14 14 14 14 14 14 14 14 14 14 14 14 14 14 14 14 14 14 14 14 14 14 14 14 14 14 14 14 14
14 14 14 14 14 14 14 14 14 14 14 14 17 17 17 14 13 14 13 13 14 13 14 13 14 17 14 14 13 13 14 13 14 14 14 14 14 14 14 14 14 14 14 14 14 14 14 14 14 14
14 14 14 14 14 14 14 14 14 14 14 14 17 14 13 14 13 13 14 13 14 13 13 13 14 17 14 13 13 14 13 14 14 14 14 14 14 14 14 14 14 14 14 14 14 14 14 14 14 14
14 14 14 14 14 14 14 14 14 14 14 13 17 13 14 13 14 13 13 13 14 14 13 14 14 17 14 14 13 13 13 13 14 14 17 17 17 17 14 14 14 14 14 14 14 14 14 14 14 14
14 14 14 14 14 14 14 14 14 14 13 14 17 17 17 17 17 17 17 17 17 13 14 13 14 17 14 13 14 13 14 13 13 14 17 17 17 17 14 14 14 14 14 14 14 14 14 14 14 14
14 14 14 14 14 14 14 14 14 14 14 13 13 13 14 13 17 14 13 17 13 14 13 13 14 17 14 13 13 13 13 13 13 14 17 17 17 17 14 14 14 14 14 14 14 14 14 14 14 14
14 14 14 14 14 14 14 14 14 14 13 13 14 13 13 13 17 13 14 17 13 13 13 14 14 17 14 14 14 14 13 14 14 14 14 14 14 17 14 13 14 14 14 14 14 14 14 14 14 14
14 14 14 14 14 14 14 14 14 14 13 14 17 17 17 17 17 13 13 17 17 17 15 14 14 17 14 13 13 13 14 13 13 13 13 13 14 17 13 14 14 14 14 14 14 14 14 14 14 14
14 14 14 14 14 14 14 14 14 14 13 13 17 13 14 17 13 14 13 17 13 13 14 13 14 17 14 14 13 13 13 13 14 13 14 13 14 17 13 14 14 14 14 14 14 14 14 14 14 14
14 14 14 14 14 14 14 14 14 14 14 13 17 14 13 17 13 13 14 13 13 14 13 13 14 17 14 13 14 13 13 14 13 13 13 13 13 17 13 13 14 14 14 14 14 14 14 14 14 14
14 14 14 14 14 14 14 14 14 14 14 13 17 13 13 13 14 13 13 14 13 13 13 14 14 17 14 13 13 14 13 13 13 14 13 17 17 17 13 13 14 14 14 14 14 14 14 14 14 14
14 14 14 14 14 14 14 14 14 14 13 14 17 13 14 13 13 14 13 13 14 14 14 14 14 17 14 14 14 13 14 13 14 13 13 17 13 13 13 14 14 14 14 14 14 14 14 14 14 14
14 14 14 14 14 14 14 14 14 14 13 13 17 17 17 17 17 17 17 17 17 17 17 17 17 17 17 17 14 13 13 13 14 13 13 17 14 13 13 13 14 14 14 14 14 14 14 14 14 14
14 14 14 14 14 14 14 14 14 14 14 13 13 13 14 14 13 13 14 13 14 14 17 13 13 13 13 17 14 14 13 14 13 17 17 17 13 14 13 14 14 14 14 14 14 14 14 14 14 14
14 14 14 14 14 14 14 14 14 14 13 13 14 13 13 13 14 13 13 13 13 14 17 13 56 57 13 17 14 13 14 13 14 17 14 14 14 13 13 13 14 14 14 14 14 14 14 14 14 14
14 14 14 14 14 14 14 14 14 14 13 14 13 13 14 13 13 13 14 14 13 14 17 13 58 59 13 17 14 14 14 14 14 17 14 14 14 14 14 14 14 14 14 14 14 14 14 14 14 14
14 14 14 14 14 14 14 14 14 14 17 17 17 17 17 17 17 17 17 17 17 17 17 13 60 61 13 17 17 17 17 17 17 17 17 17 17 17 17 17 14 14 14 14 14 14 14 14 14 14
14 14 14 14 14 14 14 14 14 14 14 14 14 14 14 14 14 14 14 14 14 14 17 13 62 63 13 17 14 14 14 14 14 17 14 14 14 14 14 14 14 14 14 14 14 14 14 14 14 14
14 14 14 14 14 14 14 14 14 14 14 14 14 14 14 14 14 14 14 14 14 14 17 13 13 13 13 17 14 13 13 13 13 17 14 13 14 13 13 14 14 14 14 14 14 14 14 14 14 14
14 14 14 14 14 14 14 14 14 14 14 14 14 14 14 14 14 14 14 14 14 14 17 17 17 17 17 17 14 13 13 14 13 17 13 14 13 13 14 13 14 14 14 14 14 14 14 14 14 14
14 14 14 14 14 14 14 14 14 14 14 14 14 14 14 14 14 14 14 14 14 14 14 14 14 17 14 14 14 13 14 13 14 17 17 17 17 17 13 13 14 14 14 14 14 14 14 14 14 14
14 14 14 14 14 14 14 14 14 14 14 14 14 14 14 14 14 14 14 14 14 14 14 14 14 17 13 13 13 14 13 13 13 17 13 13 13 17 13 14 14 14 14 14 14 14 14 14 14 14
14 14 14 14 14 14 14 14 14 14 14 14 14 14 14 14 14 14 14 14 14 14 14 14 14 17 14 13 14 13 13 14 13 17 14 13 14 18 19 19 14 14 14 14 14 14 14 14 14 14
14 14 14 14 14 14 14 14 14 14 14 14 14 14 14 14 14 14 14 14 14 14 14 14 14 17 13 13 17 17 17 17 17 17 14 13 13 18 13 13 14 14 14 14 14 14 14 14 14 14
14 14 14 14 14 14 14 14 14 14 14 14 14 14 14 14 14 14 14 14 14 14 14 14 14 17 14 13 17 14 14 14 14 14 14 13 13 18 13 13 14 14 14 14 14 14 14 14 14 14
14 14 14 14 14 14 14 14 14 14 14 14 14 14 14 14 14 14 14 14 14 14 14 14 14 17 13 14 17 17 17 17 17 17 17 17 17 18 13 13 14 14 14 14 14 14 14 14 14 14
14 14 14 14 14 14 14 14 14 14 14 14 14 14 14 14 14 14 14 14 14 14 14 14 14 17 13 13 17 13 14 13 13 14 13 13 17 18 13 13 14 14 14 14 14 14 14 14 14 14
14 14 14 14 14 14 14 14 14 14 14 14 14 14 14 14 14 14 14 14 14 14 14 14 14 17 13 14 17 13 13 14 13 13 13 14 17 18 13 13 14 14 14 14 14 14 14 14 14 14
14 14 14 14 14 14 14 14 14 14 14 14 14 14 14 14 14 14 14 14 14 14 14 14 14 17 14 13 17 13 13 14 13 14 13 14 17 18 13 13 14 14 14 14 14 14 14 14 14 14
14 14 14 14 14 14 14 14 14 14 14 14 14 14 14 14 14 14 14 14 14 14 14 14 14 17 13 13 17 17 17 17 17 17 13 13 13 18 13 13 14 14 14 14 14 14 14 14 14 14
14 14 14 14 14 14 14 14 14 14 14 14 14 14 14 14 14 14 14 14 14 14 14 14 14 17 13 14 13 13 14 13 13 14 13 14 13 18 13 13 14 14 14 14 14 14 14 14 14 14
14 14 14 14 14 14 14 14 14 14 14 14 14 14 14 14 14 14 14 14 14 14 14 14 14 14 14 14 14 14 14 14 14 14 14 14 14 14 14 14 14 14 14 14 14 14 14 14 14 14
14 14 14 14 14 14 14 14 14 14 14 14 14 14 14 14 14 14 14 14 14 14 14 14 14 14 14 14 14 14 14 14 14 14 14 14 14 14 14 14 14 14 14 14 14 14 14 14 14 14
14 14 14 14 14 14 14 14 14 14 14 14 14 14 14 14 14 14 14 14 14 14 14 14 14 14 14 14 14 14 14 14 14 14 14 14 14 14 14 14 14 14 14 14 14 14 14 14 14 14
14 14 14 14 14 14 14 14 14 14 14 14 14 14 14 14 14 14 14 14 14 14 14 14 14 14 14 14 14 14 14 14 14 14 14 14 14 14 14 14 14 14 14 14 14 14 14 14 14 14
14 14 14 14 14 14 14 14 14 14 14 14 14 14 14 14 14 14 14 14 14 14 14 14 14 14 14 14 14 14 14 14 14 14 14 14 14 14 14 14 14 14 14 14 14 14 14 14 14 14
14 14 14 14 14 14 14 14 14 14 14 14 14 14 14 14 14 14 14 14 14 14 14 14 14 14 14 14 14 14 14 14 14 14 14 14 14 14 14 14 14 14 14 14 14 14 14 14 14 14
14 14 14 14 14 14 14 14 14 14 14 14 14 14 14 14 14 14 14 14 14 14 14 14 14 14 14 14 14 14 14 14 14 14 14 14 14 14 14 14 14 14 14 14 14 14 14 14 14 14
14 14 14 14 14 14 14 14 14 14 14 14 14 14 14 14 14 14 14 14 14 14 14 14 14 14 14 14 14 14 14 14 14 14 14 14 14 14 14 14 14 14 14 14 14 14 14 14 14 14
14 14 14 14 14 14 14 14 14 14 14 14 14 14 14 14 14 14 14 14 14 14 14 14 14 14 14 14 14 14 14 14 14 14 14 14 14 14 14 14 14 14 14 14 14 14 14 14 14 14
14 14 14 14 14 14 14 14 14 14 14 14 14 14 14 14 14 14 14 14 14 14 14 14 14 14 14 14 14 14 14 14 14 14 14 14 14 14 14 14 14 14 14 14 14 14 14 14 14 14