27 27 27 27 27 27 27 27 27 27 27 27 27 27 27 27 27 27 27 27 27 27 27 27 27 27 27 27 27 27
27 27 27 27 27 27 27 27 27 27 27 27 27 27 27 27 27 27 27 27 27 27 27 27 27 27 27 27 27 27
27 27 27 32 38 38 38 38 38 38 33 27 27 27 27 27 32 38 38 38 38 38 33 27 27 27 27 27 27 27
27 27 27 37 40 40 40 40 47 40 36 27 27 27 27 32 30 40 40 40 40 40 29 33 27 27 27 27 27 27
27 27 32 30 40 47 40 40 40 40 29 38 38 33 27 37 40 40 42 40 40 40 41 36 32 38 38 38 38 33
27 27 37 40 40 40 40 47 40 47 40 40 40 44 49 48 40 40 40 40 40 40 40 44 48 40 40 40 41 36
27 27 37 40 40 47 40 40 40 40 40 40 47 36 27 34 31 40 40 40 42 40 28 35 37 41 40 40 40 36
27 27 37 47 40 40 40 40 40 40 40 40 40 36 27 27 34 39 39 39 39 39 35 32 30 40 40 40 40 36
27 27 37 40 40 40 40 40 47 40 40 47 40 36 27 27 27 27 27 27 27 27 32 30 42 40 40 42 40 36
27 27 37 40 40 40 47 40 40 40 40 40 40 29 33 27 27 27 27 27 27 27 37 40 40 40 40 40 40 36
27 27 34 31 40 28 39 39 39 31 40 40 40 40 36 27 27 27 27 27 27 32 30 40 40 40 40 40 40 36
27 27 27 34 39 35 27 27 27 34 31 40 47 40 36 27 27 27 27 32 38 30 40 40 40 42 40 40 40 36
27 27 27 27 27 27 27 27 27 27 34 39 39 45 35 27 27 27 27 37 41 40 40 40 40 40 40 40 28 35
27 27 27 27 27 27 27 27 27 27 27 27 27 50 27 27 27 27 27 34 31 40 42 40 40 40 40 28 35 27
27 27 27 27 27 27 27 27 27 27 27 27 32 46 38 38 38 38 33 27 34 39 39 39 39 39 39 35 27 27
27 27 32 38 38 38 38 38 33 27 27 32 30 40 40 41 40 41 29 33 27 27 27 27 27 27 27 27 27 27
27 32 30 40 40 40 40 40 29 33 27 37 40 40 40 40 40 40 40 36 27 32 38 38 38 38 38 33 27 27
27 37 40 40 40 40 40 40 40 44 49 48 40 40 41 40 40 40 40 36 32 40 41 41 40 41 41 29 33 27
27 37 40 40 47 40 40 40 40 29 33 34 31 40 40 40 41 40 28 35 37 41 43 40 40 40 41 41 36 27
27 37 40 40 40 40 40 40 40 40 29 33 34 39 39 39 39 39 35 32 30 40 41 40 40 40 41 40 36 27
27 37 40 40 40 40 42 40 40 40 40 36 27 27 27 27 27 27 32 30 41 41 40 41 40 40 43 41 36 27
27 37 40 40 40 40 40 40 40 40 40 36 27 27 27 27 27 27 37 40 40 40 41 40 40 41 41 43 36 27
27 37 40 42 40 40 40 40 40 40 40 36 27 27 27 27 27 27 37 40 41 40 40 40 41 41 40 40 36 27
27 37 40 40 40 40 47 40 40 40 40 29 38 33 27 27 27 27 37 40 43 41 40 40 40 40 41 40 36 27
27 37 40 40 42 40 40 40 40 40 47 40 40 29 33 27 32 38 30 41 41 40 40 41 40 41 41 40 36 27
27 37 40 40 40 40 40 40 40 40 40 40 40 40 36 32 30 41 41 40 43 41 40 40 41 41 40 40 36 27
27 37 40 40 40 40 40 40 40 42 40 40 40 40 44 48 40 40 40 40 41 40 40 40 41 40 40 41 36 27
32 30 40 40 40 42 40 40 40 40 40 40 40 38 35 34 31 43 41 40 40 40 41 40 40 40 41 43 36 27
37 40 47 40 40 40 40 40 47 40 40 40 38 35 27 27 34 39 39 39 39 39 39 39 39 39 39 39 35 27
34 39 39 39 39 39 39 39 39 39 39 39 35 27 27 27 27 27 27 27 27 27 27 27 27 27 27 27 27 27