14 14 14 14 14 14 14 14 14 14 14 14 14 14 14 14 14 14 14 14 14 14 14 14 14 14 14 14 14 14 14 14 14 14 14 14 14 14 14 14 14 14 14 14 14 14 14 14 14 14
14 14 14 14 14 14 14 14 14 14 14 14 14 14 14 14 14 14 14 14 14 14 14 14 14 14 14 14 14 14 14 14 14 14 14 14 14 14 14 14 14 14 14 14 14 14 14 14 14 14
14 14 14 14 14 14 14 14 14 14 14 14 14 14 14 14 14 14 14 14 14 14 14 14 14 14 14 14 14 14 14 14 14 14 14 14 14 14 14 14 14 14 14 14 14 14 14 14 14 14
14 14 14 14 14 14 14 14 14 14 14 14 14 14 14 14 14 14 14 14 14 14 14 14 14 14 14 14 14 14 14 14 14 14 14 14 14 14 14 14 14 14 14 14 14 14 14 14 14 14
14 14 14 14 14 14 14 14 14 14 14 14 14 14 14 14 14 14 14 14 14 14 14 14 14 14 14 14 14 14 14 14 14 14 14 14 14 14 14 14 14 14 14 14 14 14 14 14 14 14
14 14 14 14 14 14 14 14 14 14 14 14 14 14 14 14 14 14 14 14 14 14 14 14 14 14 14 14 14 14 14 14 14 14 14 14 14 14 14 14 14 14 14 14 14 14 14 14 14 14
14 14 14 14 14 14 14 14 14 14 14 14 14 14 14 14 14 14 14 14 14 14 14 14 14 14 14 14 14 14 14 14 14 14 14 14 14 14 14 14 14 14 14 14 14 14 14 14 14 14
14 14 14 14 14 14 14 14 14 14 14 14 14 14 14 14 14 14 14 14 14 14 14 14 14 14 14 14 14 14 14 14 14 14 14 14 14 14 14 14 14 14 14 14 14 14 14 14 14 14
14 14 14 14 14 14 14 14 14 14 14 14 14 14 14 14 14 14 14 14 14 14 14 14 14 14 14 14 14 14 14 14 14 14 14 14 14 14 14 14 14 14 14 14 14 14 14 14 14 14
14 14 14 14 14 14 14 14 14 14 14 14 14 14 14 14 14 14 14 14 14 14 14 14 14 14 14 14 14 14 14 14 14 14 14 14 14 14 14 14 14 14 14 14 14 14 14 14 14 14
14 14 14 14 14 14 14 14 14 14 19 19 19 19 19 19 19 19 19 19 19 19 19 19 19 19 19 19 19 19 19 19 19 19 19 19 19 19 19 14 14 14 14 14 14 14 14 14 14 14
14 14 14 14 14 14 14 14 14 14 18 13 13 13 13 13 13 13 13 13 13 13 13 13 13 14 13 13 13 13 13 13 13 13 13 12 13 13 13 14 14 14 14 14 14 14 14 14 14 14
14 14 14 14 14 14 14 14 14 14 18 13 13 12 13 13 13 16 13 13 13 13 13 13 13 14 13 13 13 13 14 13 17 17 17 17 17 17 13 14 14 14 14 14 14 14 14 14 14 14
14 14 14 14 14 14 14 14 14 14 18 13 17 17 17 17 17 17 13 13 12 13 13 13 13 14 13 13 13 13 13 13 17 13 13 13 13 17 13 14 14 14 14 14 14 14 14 14 14 14
14 14 14 14 14 14 14 14 14 14 18 13 17 13 13 13 13 17 13 13 13 13 26 13 13 14 13 13 13 12 13 13 17 13 23 24 13 17 13 14 14 14 14 14 14 14 14 14 14 14
14 14 14 14 14 14 14 14 14 14 18 13 17 13 13 13 13 17 13 13 13 13 25 13 13 14 13 13 13 13 13 13 17 13 22 21 13 17 13 14 14 14 14 14 14 14 14 14 14 14
14 14 14 14 14 14 14 14 14 14 18 13 17 13 20 13 13 17 17 17 17 17 17 13 13 14 13 13 14 13 13 13 17 13 13 13 13 17 13 14 14 14 14 14 14 14 14 14 14 14
14 14 14 14 14 14 14 14 14 14 18 13 17 13 13 13 13 17 13 17 13 13 13 13 13 14 13 13 13 13 13 13 17 17 17 17 17 17 13 14 14 14 14 14 14 14 14 14 14 14
14 14 14 14 14 14 14 14 14 14 18 13 17 17 17 17 17 17 13 17 13 13 13 13 13 14 13 13 13 13 12 13 17 13 13 13 13 13 13 14 14 14 14 14 14 14 14 14 14 14
14 14 14 14 14 14 14 14 14 14 18 13 13 13 13 13 13 13 13 17 13 13 13 13 13 13 13 13 13 13 13 13 17 14 13 14 13 13 13 14 14 14 14 14 14 14 14 14 14 14
14 14 14 14 14 14 14 14 14 14 18 13 13 13 13 13 12 13 17 17 17 17 17 17 17 17 17 17 17 17 17 17 17 14 13 13 13 16 13 14 14 14 14 14 14 14 14 14 14 14
14 14 14 14 14 14 14 14 14 14 18 13 14 13 13 13 13 13 17 13 13 13 13 13 13 13 13 13 13 17 13 13 13 14 13 13 13 13 13 14 14 14 14 14 14 14 14 14 14 14
14 14 14 14 14 14 14 14 14 14 18 13 13 13 13 13 13 13 17 13 13 13 14 13 13 13 13 13 13 17 13 16 13 14 14 14 14 14 14 14 14 14 14 14 14 14 14 14 14 14
14 14 14 14 14 14 14 14 14 14 17 17 17 17 17 17 17 17 17 13 13 12 14 13 13 13 13 16 13 17 13 13 13 14 14 13 13 13 13 14 14 14 14 14 14 14 14 14 14 14
14 14 14 14 14 14 14 14 14 14 18 13 13 13 13 13 13 13 13 13 13 13 14 14 14 14 13 13 13 17 13 13 13 13 13 13 13 13 13 14 14 14 14 14 14 14 14 14 14 14
14 14 14 14 14 14 14 14 14 14 18 16 13 13 15 13 13 15 13 13 15 13 14 13 13 13 13 13 13 17 17 17 17 13 13 13 13 13 13 14 14 14 14 14 14 14 14 14 14 14
14 14 14 14 14 14 14 14 14 14 18 13 13 13 13 13 12 13 13 13 13 13 14 13 16 13 13 13 14 13 13 13 17 13 16 13 13 13 13 14 14 14 14 14 14 14 14 14 14 14
14 14 14 14 14 14 14 14 14 14 18 13 13 13 13 13 13 13 13 13 13 13 14 13 13 13 13 14 13 13 16 13 17 13 13 13 13 13 13 14 14 14 14 14 14 14 14 14 14 14
14 14 14 14 14 14 14 14 14 14 18 15 13 13 15 13 13 15 13 13 15 13 14 13 15 12 13 16 13 13 13 13 17 13 13 12 13 13 13 14 14 14 14 14 14 14 14 14 14 14
14 14 14 14 14 14 14 14 14 14 18 13 13 13 13 13 13 13 13 13 13 13 14 13 13 13 13 13 13 13 13 14 17 13 13 13 13 13 13 14 14 14 14 14 14 14 14 14 14 14
14 14 14 14 14 14 14 14 14 14 18 13 13 13 13 13 13 13 13 13 13 13 14 13 13 13 14 13 13 13 16 13 17 13 26 13 13 13 13 14 14 14 14 14 14 14 14 14 14 14
14 14 14 14 14 14 14 14 14 14 18 15 13 13 15 13 13 15 13 13 16 13 14 13 13 16 13 13 16 13 13 13 17 13 25 13 16 13 13 14 14 14 14 14 14 14 14 14 14 14
14 14 14 14 14 14 14 14 14 14 18 13 13 13 13 13 13 13 13 13 13 13 14 15 13 13 13 13 13 13 13 13 17 13 17 13 13 13 13 14 14 14 14 14 14 14 14 14 14 14
14 14 14 14 14 14 14 14 14 14 18 13 13 13 13 13 13 13 13 13 26 13 14 13 13 13 13 16 13 12 13 13 17 13 17 13 13 13 13 14 14 14 14 14 14 14 14 14 14 14
14 14 14 14 14 14 14 14 14 14 18 15 13 13 16 13 13 15 13 13 25 13 14 13 13 14 13 13 13 13 16 13 17 17 17 17 17 15 13 14 14 14 14 14 14 14 14 14 14 14
14 14 14 14 14 14 14 14 14 14 18 13 13 13 13 13 13 13 13 13 13 13 14 13 13 13 13 16 13 13 13 13 13 13 13 13 13 13 13 14 14 14 14 14 14 14 14 14 14 14
14 14 14 14 14 14 14 14 14 14 18 13 13 13 13 13 13 13 13 13 13 13 14 13 13 13 13 13 13 13 13 13 13 15 13 13 13 13 13 14 14 14 14 14 14 14 14 14 14 14
14 14 14 14 14 14 14 14 14 14 18 15 13 13 15 13 13 15 13 13 15 13 14 13 16 13 14 13 13 12 13 13 14 13 13 13 12 13 13 14 14 14 14 14 14 14 14 14 14 14
14 14 14 14 14 14 14 14 14 14 18 13 13 13 13 13 13 13 13 13 13 13 14 13 13 13 13 13 13 13 13 13 13 13 13 13 13 13 13 14 14 14 14 14 14 14 14 14 14 14
14 14 14 14 14 14 14 14 14 14 19 19 19 19 19 19 19 19 19 19 19 19 19 19 19 19 19 19 19 19 19 19 19 19 19 19 19 19 19 14 14 14 14 14 14 14 14 14 14 14
14 14 14 14 14 14 14 14 14 14 14 14 14 14 14 14 14 14 14 14 14 14 14 14 14 14 14 14 14 14 14 14 14 14 14 14 14 14 14 14 14 14 14 14 14 14 14 14 14 14
14 14 14 14 14 14 14 14 14 14 14 14 14 14 14 14 14 14 14 14 14 14 14 14 14 14 14 14 14 14 14 14 14 14 14 14 14 14 14 14 14 14 14 14 14 14 14 14 14 14
14 14 14 14 14 14 14 14 14 14 14 14 14 14 14 14 14 14 14 14 14 14 14 14 14 14 14 14 14 14 14 14 14 14 14 14 14 14 14 14 14 14 14 14 14 14 14 14 14 14
14 14 14 14 14 14 14 14 14 14 14 14 14 14 14 14 14 14 14 14 14 14 14 14 14 14 14 14 14 14 14 14 14 14 14 14 14 14 14 14 14 14 14 14 14 14 14 14 14 14
14 14 14 14 14 14 14 14 14 14 14 14 14 14 14 14 14 14 14 14 14 14 14 14 14 14 14 14 14 14 14 14 14 14 14 14 14 14 14 14 14 14 14 14 14 14 14 14 14 14
14 14 14 14 14 14 14 14 14 14 14 14 14 14 14 14 14 14 14 14 14 14 14 14 14 14 14 14 14 14 14 14 14 14 14 14 14 14 14 14 14 14 14 14 14 14 14 14 14 14
14 14 14 14 14 14 14 14 14 14 14 14 14 14 14 14 14 14 14 14 14 14 14 14 14 14 14 14 14 14 14 14 14 14 14 14 14 14 14 14 14 14 14 14 14 14 14 14 14 14
14 14 14 14 14 14 14 14 14 14 14 14 14 14 14 14 14 14 14 14 14 14 14 14 14 14 14 14 14 14 14 14 14 14 14 14 14 14 14 14 14 14 14 14 14 14 14 14 14 14
14 14 14 14 14 14 14 14 14 14 14 14 14 14 14 14 14 14 14 14 14 14 14 14 14 14 14 14 14 14 14 14 14 14 14 14 14 14 14 14 14 14 14 14 14 14 14 14 14 14
14 14 14 14 14 14 14 14 14 14 14 14 14 14 14 14 14 14 14 14 14 14 14 14 14 14 14 14 14 14 14 14 14 14 14 14 14 14 14 14 14 14 14 14 14 14 14 14 14 14
