3 3 3 3 3 3 3 3 3 3
3 0 0 0 4 0 0 0 4 4
3 0 4 0 4 0 4 0 0 4
3 0 0 0 0 0 0 4 0 4
3 4 0 0 2 2 2 0 4 4
3 0 4 0 2 2 2 0 0 0
3 0 0 0 2 2 2 4 0 6
3 1 1 5 5 1 5 1 5 5